##########
#M # # # # 
#  ###  ##
##  ## ###
#        #
####  ####
## #    ##
###   ## #
#       I#
##########
