##########
#M     # # 
# ## ### #
#        #
####  ####
#       I#
##########
