#################
###M  # #  ## ###
###   ###   #####
####   ##  ######
###          ####
######    #######
####  #    ######
#####   ##   ####
###         I####
#################
