###############
###M # # ## ###
###  ###  #####
####  ## ######
###        ####
######  #######
#### #   ######
#####   ## ####
###       I####
###############
