###############
##  # # ##   ##
#M    ##  # # # 
# ###  #  ### #
#    ## ##    #
####       ####
## # ## ## ## #
#      #      #
#     ####   I#
###############
