#################### 
##  #  #  ##  ##  ##
##M  ##  ##  #  #  # 
##  ###  ##  ###  ##
#  ##  ##  ##  ##  #
####    ####    ####
##  ##  ##  ##  ## #
#    ##   #   ##   #
#    ##   ####   I##
####################
